7 4 4 4 4 4 4 4 4 4 4 4 4 4 8
3 0 0 0 0 0 0 0 0 0 0 0 0 0 2
3 0 10 0 0 0 0 0 0 0 0 0 0 0 2
5 1 1 1 8 0 0 0 0 0 0 7 1 1 6
9 9 9 9 2 0 0 0 0 0 0 3 9 9 9
9 9 9 9 2 0 0 0 0 0 0 3 9 9 9
9 9 9 9 2 0 0 0 0 0 0 3 9 9 9
9 9 9 9 2 12 0 0 0 0 0 3 9 9 9
9 9 9 9 9 8 0 0 0 0 0 3 9 9 9
9 9 9 9 9 2 0 0 0 0 0 3 9 9 9
9 9 9 9 9 6 0 0 0 0 0 3 9 9 9
9 9 9 9 2 0 0 0 0 0 0 3 9 9 9
9 9 9 9 2 0 0 0 0 0 12 3 9 9 9
9 9 9 9 2 0 0 0 0 0 11 3 9 9 9
9 9 9 9 2 0 0 0 0 0 7 9 9 9 9
9 9 9 9 2 0 0 0 0 0 3 9 9 9 9
9 9 9 9 2 0 0 0 0 0 5 9 9 9 9
9 9 9 9 2 0 0 0 0 0 0 3 9 9 9
9 9 9 9 2 0 0 0 0 0 12 9 9 9 9
9 9 9 9 9 12 0 0 0 0 11 9 9 9 9
9 9 9 9 9 8 0 0 0 0 7 9 9 9 9
9 9 9 9 9 2 0 0 0 0 3 9 9 9 9
9 9 9 9 2 6 0 0 0 0 5 9 9 9 9
9 9 9 9 2 0 0 0 0 0 0 3 9 9 9
9 9 9 9 2 0 0 0 0 0 0 3 9 9 9
9 9 9 9 2 0 0 0 0 0 0 3 9 9 9
9 9 9 9 2 0 0 0 0 0 0 3 9 9 9
9 9 9 9 2 0 0 0 0 0 0 3 9 9 9
9 9 9 9 2 0 0 0 0 0 0 3 9 9 9
9 9 9 9 2 0 0 0 0 0 0 3 9 9 9
9 9 9 9 2 0 0 0 13 0 0 3 9 9 9
9 9 9 9 9 4 4 4 4 4 4 9 9 9 9